11111111111
10000N00001
111S0010111
10000W00111
10000111111
10110000111
11110001111
1  10000111
1  11111111