111111111
10000N001
111S00101
10000W001
1000N1111
101100001
111100011
1  100001
1  111111