111111111111
10000N000001
111S00101101
10000W001101
1000S1111101
101100001101
111100011101
1  100001101
1  111111111