111111111
10000N001
111S00001
10000W001
1000N1111
101100001
111100011
11 100001
11 111111