  WE ./sprites/dude.png

SO    ./sprites/tile_floor.png


C   60,102,150

   EA    ./sprites/tile_wall.png    

  NO ./sprites/zombie.png

F    102,60,150   

    111111
    110001
    111111111

          1
          1
    11111111111
    11111100001
    10010000001
    10010000001
111110000000001
    10010000001
    10000100001
    10000111001
    1000000N001
    11111111111
          1   1
