111111111
100000001
11100S001
100E00N01
100001111
101100001
100000W01
111111111