  WE ./sprites/dude.png

SO    ./sprites/tile_floor.png


C   60,102,150

   EA    ./sprites/tile_wall.png    

  NO ./sprites/zombie.png

F    102,60,150   

    1111111111111
1111110000011
1001000000111
10010000001
10000000001
10010000001
1000010000111111111
10000111001
1000000N001
11111111111
