SO    ./path_to_the_south_texture
WE ./path_to_the_west_texture



C   60,102,150

EA    ./path_to_the_east_texture    

NO ./path_to_the_north_texture

F   102,60,150

  

11111111111
10010000001
10010000001
10010000001
10010000001
10010000001
10000100001
10000111001
1000000W001
11111111111
