111111111
100000001
11100S001
100000001
100001111
101100001
100000N01
111111111