111111111
100000001
111000001
100000001
100001111
101100001
100000N01
111111111