  WE ./sprites/dude.png

SO    ./sprites/tile_floor.png


C   60,102,150

   EA    ./sprites/tile_wall.png    

  NO ./sprites/tile_water.png

F    102,60,150   

  

11111111111
10010000001
10010000001
10010000001
10010000001
10010000001
10000100001
10000111001
1000000N001
11111111111
