111111111
100000001
11100S001
100E00N01
100001111
101100001
111100W11
11 100001
11 111111