111111111
100000001
111000001
100000001
1000N1111
101100001
111100011
11 100001
11 111111