11111111111111111
10000000000000001
11100010110000001
10000000110000001
10000111110000001
10110000110000001
11110001110000001
1  10000110000001
1  11111110000001
1111E000000000001
11111111111111111