  WE ./sprites/dude.png

SO    ./sprites/tile_floor.png


C   60,102,150

   EA    ./sprites/tile_wall.png    

  NO ./sprites/zombie.png

F    102,60,150   

    11111111111
    11111100001
    10010000001
    10011111101
111110001   101
    10011111101
    10000101001
    10000111001
    1000000N001
    11111111111
