11111111111
10000000001
10000000001
10000N00001
10000000001
10000000001
1000000W001
11111111111